<!DOCTYPE html>
<html lang="ko">
    <head>
        <meta charset="UTF-8" />
        <title>Document</title>
    </head>
    <body>
        <iframe src="https://www.youtube.com/embed/sE2r2sVsaBs" width="560" height="320"></iframe>
    </body>
</html>



<!-- 
    <iframe> 속성값
        src : url 등록
        width : 너비
        height : 높이
        frameborder : 주변 테두리를 표시할지 여부를 결정
        -0: 테두리를 표시 하지 않음 1: 테두리를 표시, 2: 테두리의 너비를 지정할 수 있다.
        allowedfullscreen : 전체 화면으로 볼 수 있는지 여부를 지정합니다.
        -yes : 전체 화면으로 볼수 있다. no: 볼수 없다.
        scrolling : 스크롤바를 표시할지 여부
        yes : 표시, no : 비표시
        sandbox : 보안 설정
        -allowed-same-origin : 동일한 출처의 리소스에만 액세스할 수 있습니다.
        -allow-scripts : 스크립트를 실행 할 수 있다.
        -allow-top-navigation : 상위 프레임으로 탐색할 수 있다.
        -allow-forms : 폼을 제출할 수 있다.
        -allow-popups : 팝업을 열 수 있다.
        -allow-download : 다운로드 할 수 있다.
        -allow-orientation-lock : 화면 방향을 고정할 수 있다.
        -allow-pointer-lock : 마우스 포인터를 고정할 수 있다.
        -allow-clipboard-read : 클립보드에서 데이터를 읽을 수 있다.
        -allow-clipboard-write : 클립보드에 데이터를 쓸 수 있다.
        -allow-camera : 카메라를 사용할 수 있다.
        -allow-microphone : 마이크를 사용할 수 있다.
 -->